Aglais-urticae -> Aglais-urticae:1

Apatura-iris -> Apatura-iris:1

Aphantopus-hyperantus -> Aphantopus-hyperantus:1

Argynnis-adippe -> Argynnis-adippe:1

Argynnis-aglaja -> Argynnis-aglaja:1

Argynnis-paphia -> Argynnis-paphia:1

Aricia-agestis -> Aricia-agestis:1

Aricia-artaxerxes -> Aricia-artaxerxes:1
Lysandra-bellargus:1

Boloria-euphrosyne -> Boloria-euphrosyne:1

Boloria-selene -> Boloria-selene:1

Callophrys-rubi -> Callophrys-rubi:1

Carterocephalus-palaemon -> Carterocephalus-palaemon:1

Celastrina-argiolus -> Celastrina-argiolus:1

Coenonympha-pamphilus -> Coenonympha-pamphilus:1

Coenonympha-tullia -> Coenonympha-tullia:1

Colias-croceus -> Colias-croceus:1
Hesperia-comma:1

Cupido-minimus -> Cupido-minimus:1
Plebeius-argus:1

Erebia-aethiops -> Erebia-aethiops:1

Erebia-epiphron -> Erebia-epiphron:1

Erynnis-tages -> Erynnis-tages:1

Euphydryas-aurinia -> Euphydryas-aurinia:1

Gonepteryx-rhamni -> Gonepteryx-rhamni:1

Hamearis-lucina -> Hamearis-lucina:1
Lysandra-coridon:1

Hipparchia-seleme -> Hipparchia-seleme:1

Inachis-io -> Inachis-io:1

Lasiommata-megera -> Lasiommata-megera:1

Limenitis-camilla -> Limenitis-camilla:1

Lycaena-phlaeas -> Lycaena-phlaeas:1

Maniola-jurtina -> Maniola-jurtina:1

Melanargia-galathea -> Melanargia-galathea:1

Melitaea-athalia -> Melitaea-athalia:1

Melitaea-cinxia -> Melitaea-cinxia:1

Neozephyrus-quercus -> Neozephyrus-quercus:1
Satyrium-w-album:1

Ochlodes-faunus -> Ochlodes-faunus:1

Papilio-machaon -> Papilio-machaon:1

Pararge-aegeria -> Pararge-aegeria:1

Pieris-napi -> Anthocharis-cardamines:1
Leptidea-sinapis:1
Pieris-brassicae:1
Pieris-napi:1
Pieris-rapae:1

Polygonia-c-album -> Polygonia-c-album:1

Polyommatus-icarus -> Polyommatus-icarus:1

Pyrgus-malvae -> Pyrgus-malvae:1

Pyronia-tithonus -> Pyronia-tithonus:1

Satyrium-pruni -> Satyrium-pruni:1

Thecla-betulae -> Thecla-betulae:1

Thymelicus-lineola -> Thymelicus-acteon:1
Thymelicus-lineola:1
Thymelicus-sylvestris:1

Vanessa-atalanta -> Vanessa-atalanta:1

Vanessa-cardui -> Vanessa-cardui:1
